//0 is tile
//1 is hole
//2 is gem
//3 is goldbag
//4 is spawner
//5 is player

Level: 0
100030000011114
100220020010300
130220020010000
100223023010222
100220020010222
110220020010222
010000303010000
011110000010000
200010000010002
220011151110022

Level: 1
111111003030014
022001000000010
022001022222010
322301022222010
222201000000010
222201030011110
022001022010000
033001222210220
200001022010220
220001151110000

Level: 2
111113030311114
220010202010330
200010202010220
033010202012222
222210202012222
222211111110220
022002010200220
022002010200000
200002010200002
220002050200022